000000000000000000000000000000000000
011111111111111111111111111111111110
011141111111111111111111111111111110
014111111111111111111111111111111110
011141111111111111111111111111111110
011111114111111111111111111111111110
011141111111111111111111111111111110
011111111111111111111111111111111110
011111111111111111111111111111111110
011111111111111111111111111111111110
011111111111111111111111111111111110
011111111111111111111111111111111110
011111111111111111111111111111111110
000000000000000000000000000000000000
