000000000000000000000000000000000000
011111111111111111111111111111111110
011144411111111111111111111111111110
011111111111111111111111111111111110
011111444444111111111111111111111110
011111111111114444444111111111111110
011114411111111111111111111111111110
011111111111111111111111111111111110
011111111111111111111111111111111110
011111111111111111111111111111111110
011111111111111111111111111111111110
011111111111111111111111111111111110
011111111111111111111111111111111110
000000000000000000000000000000000000