000000000000000000000000000000000000
014111111111111111111111111111111110
011111111111111111111111111111111110
014444414411114411111111111111111110
014111111111111111111111111111111110
014111114441144111111111111111111110
014411111111111111111111111111111110
011111111114111111111111111111111110
011111111114111111111111111111111110
011141111114111111111111111111111110
011111111114111111111111111111111110
011111111114444444111111111111111110
011111111111111111111111111111111110
000000000000000000000000000000000000
